magnetic levitation trains are becoming a popular transportation topic all around the globe. learn about electromagnetic suspension, the most popular type of maglev train.	magnetic_levitation electromagnetic_suspension
learn more about architecture and architects from howstuffworks.	design
frank lloyd wright's accomplishments - frank lloyd wright accomplishments include major mansions and affordable housing. read what else is on the list of frank lloyd wright accomplishments.
	frank_lloyd_wright_accomplishments
the military channel contains articles and video about different types of military technology. check out the military channel at howstuffworks.	military_technology
classic airplanes contains articles about antique and vintage types of aircraft. learn about classic planes on our classic airplanes channel.	classic_airplanes classic_planes
the modern aircraft channel includes information about airplanes and jets that were recently produced. check out our modern aircraft channel.	modern_aircraft
future aviation contains articles about technology that is under development for the aviation industry. check out the future aviation channel.	future_aviation
flight pictures show photos from aviation history. take a look at pictures of the most important aircraft in history.	flight_pictures
the geology channel explores the formation of rocks and gems, such as diamonds. learn about geology with articles and video at howstuffworks.	geology_channel
the geological processes channel helps explain how the features of the earth were formed. learn about geological processes with articles at howstuffwo	geological_processes_channel
the paleontology channel looks at the science that explores prehistoric life. here you can learn more about paleontology at howstuffworks.	paleontology_channel
aliens and ufos contains articles about the workings of extraterrestrial beings. learn about aliens and ufos on our aliens and ufos channel.	aliens_and_ufos
lots more information - for more biggest archaeological find information and information on related topics, check out these links.	biggest_archaeological_find_information biggest_archaeological_find_info
lots more information - for more archaeology information and information on related topics, check out these links.	archaeology_information
how carbon-14 is made - carbon-14 atoms are created when cosmic rays from the sun collide with atoms in the atmosphere. learn about carbon-14 atoms and carbon-14 atom creation.	cosmic_rays
consequences and health risks of nuclear bombs - nuclear bomb consequences can include radioactive fallout that can travel great distances. learn about nuclear bomb consequences.	nuclear_bomb_consequences
the matter channel contains aricles on the makeup of the universe. check out these articles on the matter channel.	matter_channel
the electricity channel contains articles about the science behind and uses for electricity. check out these articles on the electricity channel.	electricity_channel
the magnetism channel contains articles about the field of magnetism. check out these articles on the magnetism channel.	magnetism_channel
the atmospheric science channel contains information about the atmosphere. check out the atmospheric science channel.	atmospheric_science_channel
the meteorological instruments channel explains the tools that help scientists measure and collect data on the weather. check out meteorological instr	meteorological_instruments_channel
the meteorologists channel looks at the people that seek to understand why and how our atmosphere works. check out articles about meteorologists at ho	meteorologists_channel
the storms channel looks at the transfer of precipitation through our atmosphere. check out articles and pictures of storms here at howstuffworks.	storms_channel
lots more information - for more sun information and information on related topics, check out these links.	sun_information sun_info
10: explorer 1, the first u.s. satellite - explorer 1 was the first successful u.s. satellite. learn about explorer 1 and its role in discovering van allen radiation belts.	van_allen_radiation_belt
lots more information - for more water information and information on related topics, check out these links.	water_information
heat and wind - the ozone-oxygen cycle converts uv light into heat, which blocks uv rays from reaching the surface. find out how the ozone-oxygen cycle blocks uv light.	uv_light
lots more information - for more earth information and information on related topics, check out these links.	earth_information
lots more information - for more poison ivy information and information on related topics, check out these links.	poison_ivy_information
lots more information - for more kudzu information and information on related topics, check out these links.	kudzu_information kudzu_info
lots more information - to get more information about space farming, follow these links.
	information_about_space_farming
lots more information - for more bathroom in space information and information on related topics, check out these links.	bathroom_in_space_information
space suit history - spacesuit history shows the development of spacesuits from suits worn by jet pilots. learn about spacesuit history and see the mercury and gemini spacesuits.	spacesuit_history gemini_spacesuit
the future of space stations - future space stations are explained in this section. learn about future space stations.	future_space_stations future_space_station
lots more information - for more space station information and information on related topics, check out these links.	space_station_information space_station_info
geologic history of the moon - moon geology has evolved over millions of years and is continually shaped through meteor bombardment. read more about moon geology.
	moon_geology
lots more information - for more moon information and information on related topics, check out these links.
	moon_information
lots more information - for more moon colony information and information on related topics, check out these links.	moon_colony_information
it's launch time for the first privately funded space flight. in the course of battle for the x prize, a group called scaled composites has built and tested spaceshipone, a sub-orbital spacecraft intended to carry tourists on the ride of their life. learn all about the craft.	spacecraft
launching the space shuttle - launching the space shuttle requires massive thrust. see how the shuttle uses solid rocket boosters, engines and external fuel to get off the launch pad.	solid_rocket_boosters
the space shuttle in orbit - the space shuttle in orbit provides an environment for astronauts to live and work in space. learn what it's like aboard the space shuttle orbiter.	space_shuttle_orbit orbiter
work aboard the shuttle - work aboard the space shuttle includes deploying satellites and building the international space station. learn about the work of a typical shuttle mission.	international_space_station
the shuttle's return to earth - a safe space shuttle return and landing depends on dozens of factors. learn about space shuttle re-entry and what caused the columbia disaster in 2003.	space_shuttle_return
history of the space shuttle - space shuttle history was made with the first shuttle flight in 1981. learn the history of the space shuttle, including the challenger and columbia disasters.	space_shuttle_history challenger columbia
lots more information - to learn more about the space shuttle program, nasa and other space travel topics, check out these links.	nasa space_travel
solid-fuel rockets: fuel mixture - solid-fuel rocket engines were the first engines created by man. learn about solid-fuel rocket engines, solid-fuel rocket fuel mixtures and how solid fuel burns.	rocket_fuel
learn about the technology behind the ez-rocket and see how xcor plans to expand on it in the future with the rocket racing league and xerus.	rocket_racing_league erus
wave-particle duality - wave-particle duality was developed by einstein. learn about wave-particle duality and the phenomenon of light.	light
lots more information - for more light information and information on related topics, check out these links.	light_information light_info
behind the labels - you can usually figure out what's in a bottle of water by the stated water type -- like "spring water" and "purified water."  learn about the different types.	spring_water purified_water
bottled-water regulations - the fda (u.s. food and drug administration) regulates bottled water as a packaged food item. learn about those regulations.	fda
controversy: ecological effects - almost 90 percent of bottled-water bottles end up in the trash or on the ground, not in recycling bins. learn about the impact.	recycling
lots more information - for lots more information on bottled water and related topics, check out these links.	bottled_water water
anatomy of a solar cell - solar cells use several layers of different materials to aid in conducting electricity. investigate the anatomy of a solar cell.	solar_cells
energy loss in a solar cell - solar cell efficiency suffers because of band gap energy and series resistance. learn about solar cell efficiency, band gap energy and series resistance.	solar_cell_efficiency band_gap_energy series_resistance
solar-powering a house - solar power homes are possible to achieve. find out what it takes to solar power a home and how to maximize solar energy production.	solar_power_home
lots more information - for more solar cell information and information on related topics, check out these links.	solar_cell_information solar_cell_info
lots more information - for more frozen fuel information and information on related topics, check out these links.	frozen_fuel_information frozen_fuel_info
the great pacific garbage patch, the world's largest landfill, is located in the middle of the pacific. read about the great pacific garbage patch.	great_pacific_garbage_patch
the problem with plastic - the great pacific garbage patch is the world's largest landfill, and it can be found in the middle of the pacific. read about the great pacific garbage patch.	great_pacific_garbage_patch
lots more information - for more great pacific garbage patch information and information on related topics, check out these links.	great_pacific_garbage_patch_information
lots more information - for more glacier information and information on related topics, check out these links.	glacier_information
lots more information - for more iceberg information and information on related topics, check out these links.	iceberg_information
lots more information - for more train information and information on related transportation and engineering topics, explore these links.
	train_information train_info
lots more information - for more steam technology information and information on related topics, check out these links.	steam_technology_information
when someone wins the "nobel peace prize" or the "nobel prize in physics", what are they winning and why? why is it such a big deal to win the nobel prize?	peace_prize peace
lots more information - for more dynamite information and information on related topics, check out these links.	dynamite_information
lots more information - for more iron and steel information and information on related metals and topics, look over these links. 
	iron_and_steel_information
ballistic background: barrel - ballistics is the science behind what happens when a gun is fired. learn about the science of ballistics and see a diagram of how a cannon is fired.	ballistics cannon
the first guns - early guns, such as the flintlock gun and percussion cap gun, are some of the earliest types of trigger-activated guns. learn about some early guns.	early_guns flintlock_gun percussion_cap
machine guns and gun systems - early machine guns, such as the gatling gun, used a system of revolving barrels and firing pins. find out how some early machine guns worked.	early_machine_guns gatling_gun
machine gun feeding: belt system - ammunition belts consist of a long string of cartridges fastened together. find out about ammunition belt feeding systems with animations and explanations.	ammunition_belts cartridges
lots more information - for more machine gun information and information on related topics, check out these links.	machine_gun_information gun_information
lots more information - for more biological and chemical warfare information and information on related topics, check out these links.	biological_and_chemical_warfare_information biological_and_chemical_warfare_info
first robotics is a non-profit program aiming to mold young people into the science and technology leaders of tomorrow. learn about first robotics.	first_robotics
how can someone control a machine with her thoughts?	bionic_arm bionic
lots more information - for more asteroid belts information and information about other topics related to asteroid belts, try the links on this page.
	asteroid_belts_information
lots more information - for more asteroid information and information on related topics, check out these links.	asteroid_information asteroid_info
lots more information - for more asteroid mining information and information on related topics, check out these links.	asteroid_mining_information asteroid_mining_info
lots more information - for more space elevator information and information on related topics, check out these links.	space_elevator_information space_elevator_info
mars landing: author's note - to get more information about landing on mars, follow these links.
	information_about_landing_on_mars
lots more information - for more gravity information and information on related topics, check out these links.	gravity_information gravity_info
inside a nuclear power plant - nuclear power plant design depends on a containment structure, cooling systems and a steam turbine. learn how nuclear power plants work.	nuclear_power_plant_design
outside a nuclear power plant - nuclear containment helps prevent catastrophic events like the accident at chernobyl. learn about nuclear containment measures like radiation shields.	nuclear_containment radiation_shield
avian flu h5n1 - influenza a h5n1, the latest strain of bird flu, is new to humans. learn why influenza a h5n1 is a threat and what steps are being taken to prevent a pandemic.	influenza_a bird_flu
lots more information - for more dna mutation information and information on related topics, check out these links.	dna_mutation_information dna_mutation_info
spit dna is a term that is related to dna. learn about dna in saliva.	spit_dna dna_in_saliva
lots more information - for more dna in saliva information and information on related topics, check out these links.	dna_in_saliva_information
lots more information - get more information on dna profiling and other related topics with these great links.
	information_on_dna_profiling
fitting inside a cell - e-coli is able to house a long strand of dna because of dna's relationship with proteins called histones. learn about e-coli and find out how dna wraps around histones.	histones
what dna does - dna's role is to carry all of the instructions for making a protein. learn about dna's role and find out how genes relate to dna.	genes
lots more information - for more human cloning information and information on related topics, check out these links.	human_cloning_information cloning_information
lots more information - for more stem cell information and information on related topics, check out these links.	stem_cell_information stem_cell_info
lots more information - for more lake nyos information and information on related topics, check out these links.	lake_nyos_information lake_nyos_info
lots more information - for more energy source of the future information and information on related topics, check out these links.	energy_source_of_the_future_information
lots more information - for more stalactite and stalagmite information and lots of cool information about caves and spelunking, try this page.
	stalactite_and_stalagmite_information
blue skies: the size’s the limit  - for more blue sky information and information on related topics, check out these links.	blue_sky_information sky_information
approach and landing - how does air traffic control decide which planes land in which order?  learn about fast software and the crucial time before landing.	planes air_traffic_control
careers and concerns - want to be an air traffic controller?  find out how, and look at some of the problems facing air traffic control today.	air_traffic_control
can you feel the heat? solar and terrestrial radiation - solar radiation isn't the only culprit behind the heating of the atmosphere. learn the difference between solar and terrestrial radiation.
	solar_radiation
a world of wind - convection cells explain a lot about global atmospheric circulation. find out how convection cells provide you with a breath of fresh air.
	convection_cells convection_cell
lots more information - for more weather information and information on related topics such as what it's like in the eye of a hurricane, browse these links.
	weather_information
lots more information - to get more cloud information, follow these links.
	cloud_information
pumped-storage plants - pumped-storage plants have two reservoirs that are used to store more water for peak hours. learn about pumped-storage plants and the hydropower plant generator.	hydropower_plant_generator
cretaceous hyenas: tyrannosaur opportunists - cretaceous opportunists: tyrannosaur hyenas -- no definitive evidence says how t. rex ate. learn about cretaceous hyenas tyrannosaur opportunists.
	cretaceous_hyenas_tyrannosaur_opportunists
lots more information - for more fossil information and information on related topics, check out these links.	fossil_information
the chemical reaction - the chemical reaction in light sticks is called chemiluminescence. learn how chemiluminescence works and about the chemicals in light sticks.	chemiluminescence
electrostatics and coulomb's law - electrons are the basis of electricity. look inside an atom and learn the basics of electrons and how electrical insulators and electrical conductors work.	electrons insulators conductors
electricity and atomic structure - generators use a magnet to get electrons moving. learn about the relationship between electricity and magnetism and how generators help create a steady flow of electrons.	generators magnetism electrons
generators - a circuit is a path that connects the negative terminal to the positive terminal. learn how an electrical circuit works and understand the basics of electricity. 	circuit
making electricity - current, resistance and voltage are important concepts of electricity. learn about volts, amps, watts, power meters, kilowatt hours, ohms and current flow.	current resistance voltage amps volts
electrical circuits - alternating current comes from a power plant, while direct current comes from a source like a battery. learn about alternating current in relation to the power grid.	alternating_current direct_current power_grid
electric motors - ground, or electrical grounding, provides a good return path for electrons. learn about ground and the power-distribution system, from ground wires to bare wires.	ground electrical_grounding electrical_ground ground_wire
voltage, current and resistance - to find out more information about electricity and related topics, try these links.	electricity
lots more information - get more living off the grid information and read related articles on conserving home energy, solar cells, wind power, carbon footprints and more.	living_off_the_grid_information solar_cell wind_power carbon_footprint
lots more information - for more information on natural burial and information on related topics, check out these links.
	information_on_natural_burial
a human body can generate power after death with microbial fuel cell technology. learn how a body can generate power after death.
	microbial_fuel_cell microbial_fuel_cell_technology
green for eternity - green burial is becoming a popular choice for people who were environmentally conscious  in life. learn about green burial.
	green_burial
lots more information - for more information on microbial fuel cells and information on related topics, check out these links.
	information_on_microbial_fuel_cells
lots more information - for more information on the kyoto protocol and information on related topics, check out these links.
	information_on_the_kyoto_protocol
transporting carbon dioxide - transporting captured carbon is usually done through pipelines and sometimes tanker trucks. learn more about transporting captured carbon. 
	transporting_captured_carbon
is a zero-carbon city even possible? find out who is building this zero-carbon city and where it will come up with zero-carbon energy.	masdar
lots more information - for more plastics information and information on related topics, check out these links.	plastics_information
mass-produced food - consistency has become a hallmark of fast food – in each chain, restaurants look alike and meals taste the same. learn why.	consistency
lots more information - to get more sugar information and other related topics, check out these links.	sugar_information sugar_info
lots more information - for more periodic table information and information on related topics, check out these links.	periodic_table_information periodic_table_info
mining and refining aluminum - mining aluminum occurs in open-pit mines after companies locate bauxite, the primary source of aluminum. learn the other steps of mining aluminum.
	mining_aluminum
lots more information - for more lsd information and more links to drug articles, try this page.	lsd_information
how to have a lucid dream - having a lucid dream is complicated and require practice. find out how you can begin having a lucid dream.	having_a_lucid_dream
what do our dreams mean? - what do dreams mean is a common question for most people. learn about common dreams, interpretations of dreams and common symbols in dreams.	what_do_dreams_mean common_dreams interpretations_of_dreams
health benefits of caffeine - for more caffeine information and more articles about caffeine and coffee, check out the links on this page.	caffeine_information articles_about_caffeine
