how chameleons change color and why they do it 	
science 	science
environmental science 	environmental_science
physical science 	physical_science
innovation 	innovation
life science 	life_science
engineering 	engineering
science versus myth 	science_versus_myth
afterlife 	afterlife
everyday myths 	everyday_myths
strange creatures 	strange_creatures
what if 	what_if
does marie antoinette still roam the halls of versailles? 	
transportation 	transportation
engines & equipment 	engines equipment
the maglev track 	maglev_track
maglev trains: lots more information 	maglev train
how electromagnets work 	electromagnet magnet  k
devices 	devices device
civil engineering 	civil_engineering civil_engineer
materials science 	materials_science
robots 	robots robot
structural engineering 	structural_engineering structural_engineer
moscow's st. basil's cathedral in 7 different architectural styles 	
how frank lloyd wright worked 	frank_lloyd_wright
the women of frank lloyd wright 	women_of_frank_lloyd_wright
frank lloyd wright homes 	frank_lloyd_wright_homes
frank lloyd wright buildings  	frank_lloyd_wright_buildings
frank lloyd wright school of architecture 	frank_lloyd_wright_school_of_architecture
preservation and restoration of frank lloyd wright architecture 	frank_lloyd_wright_architecture
how skyscrapers work 	skyscrapers
skyscraper pictures 	skyscraper_pictures
military aircraft 	military_aircraft
modern military planes 	modern_military_planes
world war i planes 	world_war_i_planes
world war ii planes 	world_war_ii_planes
f-35as put to the test in first-ever 'elephant walk' 	
how the u.s. air force works 	air_force
military branches 	military_branches
army careers 	army_careers army_career
biological warfare 	biological_warfare
firearms 	firearms
future military technology 	future_military_technology
naval technology 	naval_technology
personal finance in the military 	personal_finance_in_the_military
soldiers 	soldiers soldier
surveillance and stealth 	surveillance_and_stealth surveillance stealth
tanks and fighting vehicles 	tanks_and_fighting_vehicles tanks fighting_vehicles
recovered 'lost squadron' plane leads to new mystery 	
classic airplanes 	classic_airplanes
flight 	flight
how airplanes work 	airplane airplanes
will the faa ever regulate legroom on commercial planes? 	
what causes an iceberg to flip? 	
earth science 	earth_science
archaeology 	archaeology
minerals 	mineral
fettuccine rock could signal life on mars 	
want to find past life on mars? dive deep into earth first 	
space 	space
astronomy 	astronomy
constellations 	constellations constellation
observatories 	observatories
stars 	stars star
the solar system 	solar_system
how comets work 	comet how_comets_work
science dictionary 	science_dictionary
astronomy terms 	astronomy_terms
awards and organizations 	awards_and_organizations
famous scientists 	famous_scientists famous_scientist scientists
astronomers 	astronomers astronomer
biologists 	biologists biologist
peter brian medawar 	peter_brian_medawar
american biologists 	american_biologists american_biologist
10 things you should know about rachel carson 	
oceanography 	oceanography
geophysics 	geophysics
lapis lazuli found in teeth of medieval european woman 	
peat bogs are freakishly good at preserving human remains 	
what's the biggest archaeological find in history? 	biggest_archaeological_find
pompeii takes the prize 	pompeii
another avellino eruption on the way? 	avellino_eruption avellino
how archaeology works 	archaeology
the history of archaeology 	history_of_archaeology
an archaeologist's work: fieldwork and excavation 	fieldwork
amateur archaeology and robbers  - amateur archaeology and robbers 	amateur_archaeology
how carbon-14 dating works 	carbon carbon
dating a fossil - carbon dating 	carbon_dating
how nuclear bombs work 	nuclear_bombs nuclear_bomb
atomic structure and radioactivity 	atomic_structure_and_radioactivity atomic_structure
nuclear fission 	nuclear_fission
nuclear fuel 	nuclear_fuel
fission bomb design 	fission_bomb_design fission_bomb
fission bomb triggers 	fission_bomb_triggers
fusion bombs 	fusion_bombs fusion_bomb
nuclear bomb delivery 	nuclear_bomb_delivery
nuclear bomb: lots more information 	nuclear_bomb
image gallery: inside a nuclear power plant 	nuclear_power_plant inside_a_nuclear_power_plant
nuclear science 	nuclear_science
acoustics 	acoustics
chemistry 	chemistry
chemical elements 	chemical_elements elements
chemical compounds 	chemical_compounds compounds
chemical processes and tests 	chemical_processes_and_tests chemical_processes chemical_process
what are isotopes? 	
how atoms work 	atoms atom
forensic science 	forensic_science forensic
history of physical science 	history_of_physical_science
math concepts 	math_concepts math
optics 	optics
skipping stones on ice makes crazy sci-fi sounds 	
why ice usually freezes cloudy, not clear 	
forces of nature 	forces_of_nature
climate & weather 	climate weather
why does the u.s. use fahrenheit instead of celsius? 	
green science 	green_science green
conservation 	conservation
conservation issues 	conservation_issues conservation_issue conservation
is it ok to take sand dollars off the beach? 	
where have all the seashells gone? 	
future space 	future_space
spaceflight 	spaceflight
space transportation systems 	space_transportation_systems space_transportation_system space_transportation
communicating with aliens is hard. communicating with alien ai could be harder 	
are we alone? the drake equation 	are_we_alone
how stars work 	stars star how_stars_work
how the sun works 	sun
the parts of the sun 	parts_of_the_sun
the sun's interior: radiative and convective zones 	convective_zones convective_zone
the sun's features: sunspots, solar prominences and solar flares 	sunspots solar_flares
the fate of the sun 	fate_of_the_sun
how solar eclipses work 	eclipse solar_eclipse
how telescopes work 	telescope how_telescopes_work telescopes
nasa's 10 greatest achievements 	nasa
9: hubble space telescope, the universe unveiled - hubble space telescope, the universe unveiled (1990-present) 	hubble_space_telescope hubble
7: the juno spacecraft, a trip to jupiter - the juno spacecraft, a trip to jupiter (2011-present) 	jupiter
6: apollo 13, brilliance at mission control - apollo 13, brilliance at mission control (1970) 	apollo mission_control
5: the space shuttle, a reusable spacecraft - the space shuttle, a reusable spacecraft (1972-2011) 	space_shuttle spacecraft
3: the mars science laboratory, a rockhound on the red planet - the mars science laboratory, a rockhound on the red planet (2012-present) 	mars
2: freedom 7, the first american in space - freedom 7, the first american in space (1961) 	freedom_7
1: apollo 11, a walk on the moon - apollo 11, a walk on the moon (1969) 	apollo
two for teegarden: pint-sized star system discovered right next door 	
how water works 	water ho
the world's water supply 	water_supply
water regulation 	water_regulation
human water consumption 	human_water_consumption
water purification 	water_purification
plant and animal water consumption 	plant_and_animal_water_consumption animal_water_consumption
the water cycle 	water_cycle
water properties 	water_properties
how the earth works 	earth
power and light - sun energy 	sun_energy
night and day 	night day
sugar and carbon - the photosynthesis cycle 	photosynthesis_cycle
water and fire - the water cycle 	water_cycle water fire
planets and stars - the origin of the earth 	origin_of_the_earth
how volcanoes work 	volcanoes volcano
natural disasters 	natural_disasters natural_disaster
how to prepare for a flood 	
why flash floods are so dangerous 	
how floods work 	floods
storm pictures 	storm_pictures storm
how hurricanes work 	hurricanes how_hurricanes_work
how dinosaurs work 	dinosaurs dinosaur
dinosaur facts 	dinosaur_facts
skin and bones: dinosaur appearance 	dinosaur_appearance
in cold (or warm) blood: dinosaur physiology 	dinosaur_physiology
like birds on nests: dinosaur reproduction 	dinosaur_reproduction
taking wing: birds and living dinosaurs 	living_dinosaurs
cretaceous park: dinosaur movies and myths 	dinosaur_movies
dinosaur summary 	dinosaur_summary
how dinosaurs work: lots more information 	dinosaurs
how dna works 	dna
cellular & microscopic biology 	microscopic_biology
biological fields 	biological_fields
botany 	botany
flowering plants, shrubs and trees 	flowering_plants shrubs trees
how to treat poison sumac 	
how poison ivy works 	poison_ivy
poisonous plants 	poisonous_plants
poison ivy and the immune system 	poison_ivy_and_the_immune_system
poison ivy symptoms and treatment - poison ivy symptons and treatment 	poison_ivy_symptoms
avoiding poison ivy 	avoiding_poison_ivy
what is urushiol? 	urushiol
how kudzu works 	kudzu
how kudzu grows 	kudzu_grows
alternative uses for kudzu 	alternative_uses_for_kudzu uses_for_kudzu
more kudzu products 	more_kudzu_products kudzu_products kudzu
kudzu control 	kudzu_control
how space farming works 	space_farming
the challenges of space farming  	challenges_of_space_farming
the impact of space farming 	impact_of_space_farming
how does going to the bathroom in space work? 	bathroom_in_space
life in space 	life_in_space
how space suits work 	space_suits
what a space suit does - spacesuit capabilities 	spacesuit_capabilities
project apollo space suit 	apollo_space_suit apollo
modern space suit: emu 	modern_space_suit
modern space suit: upper torso 	upper_torso
putting on a spacesuit 	putting_on_a_spacesuit
spacesuits: lots more information 	spacesuits
how space stations work 	space_stations space_station space
why should we build space stations? 	build_space_stations
salyut: the first space station 	salyut space_station
skylab: america's first space station 	skylab
mir: the first permanent space station 	mir
the international space station (iss) 	international_space_station iss space_station
how mars works 	mars
venus explained 	venus
worm, strawberry, blue: every full moon has a name 	
how the moon works 	moon
what's on the surface of the moon? 	surface_of_the_moon
giant impactor hypothesis 	giant_impactor_hypothesis
moon phases 	moon_phases
return to the moon 	return_to_the_moon
what if we lived on the moon? 	what_if_we_lived_on_the_moon
moon colony resources 	moon_colony_resources
how space tourism works 	space_tourism
commercial space travel 	commercial_space_travel
space accommodations - space hotels 	space_hotels space_hotel space_accommodations
who gets to go? - space adventures 	space_adventures
space tourism: lots more information 	space_tourism
how gliders work 	glider
how space shuttles work 	space_shuttle
space shuttle liftoff 	space_shuttle_liftoff
space shuttle positioning, communication and navigation 	space_shuttle_position
space shuttle improvements 	space_shuttle_improvements
preventing future space shuttle disasters 	space_shuttle_disaster
how rocket engines work 	rocket_engines
action and reaction: the space baseball scenario - rocket physics: the space baseball scenario 	rocket_physics
thrust 	thrust
solid-fuel rockets: channel configuration - solid fuel rockets: channel configuration 	channel_configuration
the future of rocket engines 	future_of_rocket_engines
rocket engines: lots more information 	rocket_engines
how fire works 	fire
how light works 	light how_light_works
what is light? 	what_is_light
light as rays 	light_as_rays
light as waves 	light_as_waves light
light frequencies 	light_frequencies light
light as particles 	light_as_particles
producing a photon 	producing_a_photon
bioluminescence: how organisms light things up 	bioluminescence light
incandescence: creating light with heat 	incandescence light
lasers 	lasers
making colors 	making_colors
pigments and absorption 	pigments_and_absorption
origin of light 	origin_of_light light
how much coal is required to run a 100-watt light bulb 24 hours a day for a year? 	coal
energy production 	energy
green technology 	green_technology green_tech
energy production technologies 	energy_production_technologies
remediation technologies 	remediation_technologies
sustainable technologies 	sustainable_technologies sustainable_tech
sustainable technologies at home 	sustainable_technologies_at_home
what do the numbers inside recycling symbols on plastic items mean? 	plastic recycling recycling_symbols
how recycling works 	recycling
recycling history 	recycling_history
benefits of recycling 	benefits_of_recycling
recycling guidelines 	recycling_guidelines
other recycled items - recycled items 	recycled_items
recycling centers 	recycling_centers recycling_center
recycling criticisms 	recycling_criticisms
recycling: lots more information 	recycling
how bottled water works 	bottled_water water
how global warming works 	global_warming
weather and climate - climate and weather 	climate weather
the greenhouse effect 	greenhouse_effect
how terraforming mars will work 	mars terraforming terraforming_mars
how solar sails work 	solar_sail
solar sail concept 	solar_sail_concept
solar sail materials 	solar_sail_materials
solar sail launch 	solar_sail_launch solar_sail
future space travel 	future_space_travel
how solar sails work: lots more information 	solar_sails
how solar sail technology works 	solar_sail solar_sail_technology
how solar cells work 	solar_cells
photovoltaic cells: converting photons to electrons - photovolatic cells: converting photons to electrons 	photovoltaic_cells
how silicon makes a solar cell 	silicon
solving solar power issues - solving solar-power issues 	solar_power_issues
finishing your solar power setup  	solar_power_setup
developments in solar cell technology 	solar_cell_technology
solar power costs 	solar_power_costs solar_power_cost
how solar thermal power works 	solar_thermal_power
solar thermal systems 	solar_thermal_systems
solar thermal heat 	solar_thermal_heat
solar thermal greenhouses 	solar_thermal_greenhouses
solar thermal chimneys 	solar_thermal_chimneys
solar thermal power: lots more information 	solar_thermal_power
how frozen fuel works 	frozen_fuel
fire and ice: the chemistry of methane hydrate 	chemistry_of_methane_hydrate methane_hydrate
a brief history of methane hydrate 	history_of_methane_hydrate
the potential of frozen fuel 	potential_of_frozen_fuel
the risky business of mining methane hydrate 	mining_methane_hydrate
the future of frozen fuel 	future_of_frozen_fuel
sustainable technologies in the community 	sustainable_technologies_in_the_community
new technology turns a sunny day into safe water 	
have we hit the peak recycling point? 	
china says we don't want your plastic 	
how landfills work 	landfill
effects of plastic and the great pacific garbage patch 	effects_of_plastic
if the polar ice caps melted, how much would the oceans rise? 	polar ice ice_cap ocean
glacier pictures 	glacier_pictures glacier_picture
how glaciers work 	glaciers glacier
glacier formation 	glacier_formation
anatomy of a glacier 	anatomy_of_a_glacier
geologic effects 	geologic_effects geologic_effect
more glacier terms 	glacier_terms
ice ages and global warming 	ice_ages
how icebergs work 	icebergs iceberg
iceberg basics 	iceberg_basics
iceberg life cycle 	iceberg_life_cycle
iceberg statistics 	iceberg_statistics
iceberg ecology 	iceberg_ecology
iceberg danger 	iceberg_danger
avalanches: the science of snow disasters 	avalanches disaster
how diesel locomotives work 	locomotives diesel
how trains work 	trains train
full steam ahead: locomotives and train technology 	train_technology
keeping us in line: train tracks 	train_tracks train_track
freight railroad systems 	freight_railroad
passenger railroad systems 	passenger_railroad
the future of train transportation  - the future of train transportation 	train_transportation
how steam technology works 	steam_technology
early steam history 	early_steam_history steam_history
the first steam engines 	first_steam_engines first_steam_engine
watt and the steam engine 	steam_engine
the cornish engine  - the cornish engine 	cornish_engine
the steam locomotive 	steam_locomotive
the steamship 	steamship
the steam turbine 	steam_turbine
modern steam 	modern_steam
how steam engines work 	steam steam_engine  k
should we be jittery about train travel? 	
still riding the rails: life as a modern hobo 	
science questions 	science_questions
big thinkers 	big_thinkers
edible innovations 	edible_innovations innovation edible_innovations
everyday innovations 	everyday_innovations innovations innovation
famous inventors 	famous_inventors inventors famous_inventor inventor
inventions 	inventions invention
nasa inventions 	nasa_inventions nasa_invention
new inventions 	new_inventions new_invention
repurposed inventions 	repurposed_inventions inventions
jane goodall: a global face for global peace 	
what is dynamite and how does it work? 	dynamite
how building implosions work 	building_implosions implosion 
how iron and steel work 	iron steel iron_and_steel
the advantages of iron 	advantages_of_iron
iron ore 	iron_ore
creating iron 	creating_iron
creating steel 	creating_steel
how flintlock guns work 	flintlock gun flintlock_gun  k
how machine guns work 	machine_guns guns
revolvers 	revolvers revolver
machine gun recoil systems 	recoil recoil_system
machine gun blowback systems 	blowback_system
machine gun gas systems 	machine_gun_gas_system
machine gun feeding: spring and hopper system 	machine_gun_feeding
how rocket-propelled grenades work 	grenade
how grenades work 	grenade
how biological and chemical warfare works 	chemical_warfare
understanding warfare 	understanding_warfare warfare
the basics of chemical and biological weapons 	basics_of_chemical_and_biological_weapons
feared chemical agents 	feared_chemical_agents chemical_agents chemical_agent
feared biological agents 	feared_biological_agents feared_biological_agent biological_agents
the spread of biological and chemical agents 	spread_of_biological_and_chemical_agents
how anthrax works 	anthra
how cells work 	cell
how light microscopes work 	microscope
how corrective lenses work 	corrective_lenses lenses corrective_lens lens
toilets: the past and future of the flush 	
3: flat earth society - flat earth society 	flat_earth_society
5: planet x - planet x theory 	planet
7: illuminati and majestic-12 - illuminati and majestic-12 theories 	illuminati
9: shifting poles - shifting poles theory 	shifting_poles
10: the dead cosmonaut - dead cosmonaut theory 	dead_cosmonaut
top 10 space conspiracy theories 	space_conspiracy_theories
the solar system explained 	solar_system
the truth behind the rogue planet nibiru 	
top 10 doomsday prophecies 	1
how aliens work 	alien
ufo pictures 	ufo_pictures ufo_picture
9 'unsolved' mysteries that have been solved 	mysteries
did the mayan civilization end because of climate change? 	climate_change maya civilization
how pyramids work 	pyramids pyramid
egyptian pyramids 	egyptian_pyramids egyptian_pyramids
the great pyramid of khufu 	great_pyramid
building the pyramids 	building_the_pyramids
pyramid construction 	pyramid_construction
pyramid workforce 	pyramid_workforce
pyramids: lots more information 	pyramids pyramid
how mummies work 	mummies
egyptian mummification 	egyptian_mummification mummification
egyptian mummification: embalming - egyptian embalming 	egyptian_embalming
egyptian mummification: drying and wrapping - mummy wrapping 	mummy_wrapping
other ancient mummies 	ancient_mummies
modern mummies 	modern_mummies
mummies: lots more information 	mummies
how dna evidence works 	dna_evidence how_dna_evidence_works
genetic science 	genetic_science
inside the mind 	inside_the_mind
emotions 	emotions
can science explain why we kiss with our eyes closed? 	
yes, you can be allergic to vibrations 	
study: elderly see potential in robotic help, but worry about robot autonomy 	
how robots work 	robots
robot basics 	robot_basics
the robotic arm 	robotic_arm
mobile robots 	mobile_robots
autonomous robots 	autonomous_robots
homebrew robots 	homebrew_robots
robots and artificial intelligence 	artificial_intelligence robots
robots: lots more information 	robots
robot pictures 	robot_pictures
how robotic surgery will work 	robotic_surgery
how asimo works 	asimo
asimo's motion: walk like a human - asimo motions 	asimo_motions
asimo's motion: smooth moves - asimo movements 	asimo_movements
asimo's senses - asimo senses 	asimo_senses
controlling and powering asimo - asimo controls and power 	asimo_controls
asimo's life story - asimo timeline 	asimo_timeline
asimo's peers - humanoid robots 	humanoid_robots
asimo: lots more information 	asimo
how brainport works 	brainport
concepts of electrotactile stimulation - electrotactile stimulation 	electrotactile_stimulation
brainport 	brainport
the brainport vision device 	brainport_vision_device brainport_vision
brainport: lots more information 	brainport
how your brain works 	brain
the human brain 	human_brain the_human_brain
study solves why drinking gives you the munchies 	
the mandela effect: why we recall events that didn't occur 	
what is the multiverse? 	
can supersymmetry and the multiverse both be true simultaneously? 	
how dark matter works 	dark_matter
how planet hunting works 	planet_hunting
10 remarkable exoplanets 	
10: epsilon eridani b - 10 remarkable exoplanets 	
how asteroid belts work 	asteroid_belts asteroid_belt
the formation of the solar system 	formation_of_the_solar_system
the main asteroid belt 	asteroid_belt the_main_asteroid_belt
asteroid characteristics 	asteroid_characteristics
how asteroids work 	asteroids asteroid
asteroid classification 	asteroid_classification
project near 	project_near
near lands on eros 	near_lands_on_eros eros
how asteroid mining will work 	asteroid_mining
valuable asteroid resources 	valuable_asteroid_resources asteroid_resources asteroid_resource
how space planes will work 	space_plane
how space elevators will work 	space_elevators
space elevator ribbon 	space_elevator_ribbon
riding a space elevator to the top 	riding_a_space_elevator_to_the_top riding_a_space_elevator
space elevator maintenance 	space_elevator_maintenance
space elevator impact 	space_elevator_impact
how light propulsion will work 	light_propulsion propulsion
how lasers work 	laser lasers
could i see a flashlight beam from earth on the moon? 	moon light
nasa's insight mission detects its first marsquake 	
nasa's insight will probe mars' quakes, temperature and wobble to understand its origins 	
how the mars curiosity rover works 	mars_curiosity_rover curiosity_rover
mars landing pictures 	mars
how will landing on mars work? 	landing_on_mars
challenges of a mars landing 	challenges_of_a_mars_landing
prospective mission plan to mars 	mission_plan_to_mars
the details of landing on mars  	details_of_landing_on_mars
how satellites work 	satellite satellites
how isaac newton worked 	isaac_newton newton
physicists 	physicists
stephen hawking's last paper takes on the multiverse 	
10 cool things you didn't know about stephen hawking 	stephen_hawking
how does gravity work? 	gravity
how nuclear radiation works 	radiation nuclear
how submarines work 	submarine sub submarines how_submarines_work
how nuclear power works 	nuclear_power
nuclear fission: the heart of the reactor 	nuclear_fission
pros and cons of nuclear power 	pros_and_cons_of_nuclear_power
nuclear catastrophe and reactor shutdown 	nuclear_catastrophe_and_reactor_shutdown
nuclear power: lots more information 	nuclear_power
japan tsunami and earthquake pictures 	japan_tsunami tsunami earthquake
could a single volcanic eruption destroy all life on earth? 	
how much energy in a hurricane, a volcano, and an earthquake? 	energy hurricane volcano earthquake
how nasa planetary protection works 	nasa planetary_protection
how area 51 works 	area
10 false science facts everyone knows 	
10 misconceptions about the flu 	flu
how the flu works 	flu
what is the flu? 	the_flu
how do you get the flu virus? - flu virus 	flu_virus
who has a flu risk? - flu risk 	flu_risk
flu remedies 	flu_remedies
avoiding the flu 	avoiding_the_flu
flu vaccine 	flu_vaccine
who should get a flu shot? 	flu_shot who_should_get_a_flu_shot
how bird flu works 	bird_flu 
viruses and influenza: an overview 	viruses_and_influenza
avian flu 	avian_flu
a global flu pandemic 	flu_pandemic
bird flu: lots more information 	
how viruses work 	virus
how aids works 	aids
what causes dna mutation? 	dna_mutation mutation dna
types of genetic tests 	types_of_genetic_tests
from spit to snp: the basic process 	snp
genetic markers 	genetic_markers genetic_marker
genetic testing laws 	genetic_testing_laws genetic_testing_law
how dna profiling works 	dna_profiling
creating a dna profile 	dna_profile dna_profile
use of dna profiles in law enforcement - how dna profiling works 	dna_profiling dna_profile
use of dna profiles in genealogy 	dna_profiles_in_genealogy
controversy in dna profiling - how dna profiling works 	dna_profiling
dna structure 	dna_structure
dna replication 	dna_replication
building a protein: transcription - the transcription process 	transcription transcription_process
building a protein: translation - translation 	translation
the protein synthesis process - protein synthesis 	protein_synthesis
dna  mutation, variation and sequencing - dna mutation 	dna_mutation
dna: lots more information 	dna
how gene pools work 	gene_pools
how cloning works 	cloning
how human cloning will work 	human_cloning
creating a human clone - how human cloning will work 	human_cloning human_clone
cloning uses 	cloning_uses
human cloning ethics 	human_cloning_ethics cloning_ethics
how stem cells work 	stem_cells
stem cell basics 	stem_cell_basics
embryonic stem cells 	embryonic_stem_cells embryonic_stem_cell stem_cells
adult stem cells 	adult_stem_cells adult_stem_cell stem_cells
induced pluripotent stem cells (ipscs) 	ipscs ipsc
using stem cells to treat disease 	using_stem_cells_to_treat_disease
stem cell research controversy 	stem_cell_research_controversy stem_cell_research
men's beards carry more bacteria than dogs' fur, study suggests 	
why are australia's pink lakes pink? 	
how did lake nyos suddenly kill 1,700 people? 	lake_nyos
investigating the nyos disaster 	nyos_disaster nyos_disaster
lake monoun and other exploding lakes 	lake_monoun
recipe for a killer lake 	killer_lake
degassing lakes with big straws 	degassing_lakes degassing
how earthquakes work 	earthquakes how_earthquakes_work
what is the biggest energy source of the future?  	energy_source_of_the_future
what is cave popcorn? 	
what's the difference between stalactites and stalagmites? 	stalactites_and_stalagmites stalactites
the formation of stalactites and stalagmites 	formation_of_stalactites_and_stalagmites
why is the sky blue? 	sky why_is_the_sky_blue
echo and doppler shift 	echo doppler_shift
how radar works 	radar
how air traffic control works 	air_traffic_control
flight profile and preflight 	preflight
air traffic control problems 	air_traffic_control_problems air_traffic_control_problem
air traffic control: lots more information 	air_traffic_control
how airports work 	airport
how weather works 	weather
evolution of the atmosphere 	evolution_of_the_atmosphere
under (atmospheric) pressure 	pressure
a recipe for wind 	wind
the cycle of rain 	rain cycle_of_rain
when air masses collide 	air_masses
stormy skies 	stormy_skies
how clouds work 	clouds cloud
types of clouds 	types_of_clouds
how clouds form 	how_clouds_form
clouds and precipitation 	clouds_and_precipitation
the purpose of clouds  	purpose_of_clouds
rare clouds 	rare_clouds
how acid rain works 	acid_rain acid
the ph of acid rain - acid rain ph 	acid_rain_ph ph_of_acid_rain
the effects of acid rain 	effects_of_acid_rain
reducing acid rain - solutions to acid rain 	solutions_to_acid_rain
acid rain: lots more information 	acid_rain acid
how hydropower plants work 	hydropower_plants hydropower_plant hydropower power_plant
the power of water - hydropower plant parts 	hydropower_plant_parts
hydrologic cycle 	hydrologic_cycle
hydroelectric footwear 	hydroelectric_footwear
hydropower plants: lots more information 	hydropower_plants hydropower_plant hydropower power_plant
how power grids work 	power power_grids how_power_grids_work
nuclear power pictures 	nuclear_power_pictures
could we resurrect dinosaurs from fossil embryos? 	
fossil pictures 	fossil
what's so special about a dinosaur named leonardo? 	dinosaur_named_leonardo
mummified dinosaur fossils 	mummified_dinosaur_fossils dinosaur_fossils
was tyrannosaurus rex a predator or a scavenger? 	tyrannosaurus_re
can scientists clone dinosaurs? 	clone_dinosaurs dinosaurs clone
mammoths and dinosaur cloning 	mammoths
lots more information - can scientists clone dinosaurs? 	dinosaurs
how fossils work 	fossils fossil
building up and breaking down: geology and decomposition 	decomposition
bone to stone: building fossils 	building_fossils
mummies, tar and amber 	tar amber
the search for fossils 	search_for_fossils
knowledge from stone: studying fossils 	studying_fossils
how evolution works 	evolution
how food works 	food  k
how bread works 	bread
how alcohol works 	alcohol
how beer works 	beer
what if everyone on earth had easy access to clean water? 	what_if water
can the sun clean water: lots more information 	sun_clean_water
how oil drilling works 	oil_drilling oil
forming oil 	forming_oil oil
locating oil 	locating_oil
oil drilling preparation 	oil_drilling_preparation oil_drilling_prep
oil rig systems 	oil_rig_systems oil_rig
the oil drilling process 	oil_drilling_process oil_drilling
testing for oil 	testing_for_oil
offshore oil drilling 	offshore_oil_drilling
oil drilling: lots more information 	oil_drilling oil
how oil refining works 	oil refining
oil field pictures 	oil_field_pictures oil_field
could glow-in-the-dark plants replace streetlights? 	
how black lights work 	black_lights
black light designs 	black_light_designs
black light uses 	black_light_uses
black lights: lots more information 	black_lights
how light sticks work 	light_sticks
the activator - light stick activation 	light_stick_activation
light sticks: lots more information 	light_sticks
how electricity works 	electricity electric
how living off the grid works 	living_off_the_grid
solar and wind energy 	solar_and_wind_energy wind_energy
water and sewer off grid 	water_and_sewer_off_grid
augmenting home energy - augmemting home energy 	augmenting_home_energy
off-the-grid lifestyle - off the grid lifestyle 	off_the_grid_lifestyle
mushroom burial suit creates life after death 	
what if you drank embalming fluid? 	
how embalming works 	embalming
how coffins work 	coffin coffins
how natural burial works 	natural_burial
traditional burial 	traditional_burial
green burial 	green_burial
green options beyond burial 	green_options_beyond_burial
10 wacky forms of alternative energy 	wacky_forms_of_alternative_energy
10: muscle power - 10 wacky forms of alternative energy 	wacky_forms_of_alternative_energy
9: text 1-800-piezoelectricity - 10 wacky forms of alternative energy 	wacky_forms_of_alternative_energy
8: hot air as fuel - 10 wacky forms of alternative energy 	wacky_forms_of_alternative_energy
7: capturing methane emissions from cows - 10 wacky forms of alternative energy 	wacky_forms_of_alternative_energy
what is the greenhouse effect? 	greenhouse_effect greenhouse
trapping heat 	trapping_heat
trapping too much heat 	trapping_too_much_heat heat
what happens when the kyoto protocol expires? 	kyoto_protocol
how carbon trading works 	carbon_trading
mandatory carbon trading 	mandatory_carbon_trading
voluntary carbon trading 	voluntary_carbon_trading
carbon trading: lots more information 	carbon_trading carbon
how carbon offsets work 	carbon_offsets carbon_offset carbon
the theory behind carbon offsets - carbon offset theories 	carbon_offset_theories
why do people buy carbon offsets? - buying carbon offsets 	buying_carbon_offsets
emerging standards and how to buy offsets - carbon offset standards 	carbon_offset_standards
carbon offsets: lots more information 	carbon_offsets carbon_offset carbon
how carbon footprints work 	carbon_footprint carbon_footprints carbon
calculating carbon footprints 	calculating_carbon_footprints calculating_carbon_footprint
reducing carbon footprints 	reducing_carbon_footprints reducing_carbon_footprints
carbon footprints: lots more information 	carbon_footprints carbon_footprint carbon
how carbon tax works 	carbon_ta
will there be a national carbon tax? - national carbon tax 	national_carbon_ta
carbon tax: lots more information 	carbon_ta
what is clean coal technology? 	clean_coal clean_coal_technology coal
where do the emissions go? - clean coal emissions 	clean_coal_emissions coal_emissions
clean coal: lots more information 	clean_coal
how carbon capture works 	carbon_capture
trapping carbon dioxide: carbon capture technology 	carbon_capture_technology
carbon storage 	carbon_storage
carbon storage concerns 	carbon_storage_concerns
carbon capture: lots more information 	carbon_capture
how masdar city will work 	masdar_city
is what we're recycling actually getting recycled? 	recycling
how plastics work 	plastics plastic
plastics history 	plastics_history
chemistry of plastics 	chemistry_of_plastics
condensation and addition reactions 	addition_reactions addition_reaction
types of plastics 	types_of_plastics types_of_plastic
making plastics 	making_plastics making_plastic
biopolymers and recycling 	biopolymers biopolymer
how gasoline works 	gas gasoline
how fast food works 	fast_food
how food preservation works 	food_preservation
refrigeration and freezing 	freezing
canning food 	canning_food canning
dehydrating food 	dehydrating_food
salting and pickling 	salting_and_pickling 
pasteurizing, fermenting, carbonating 	pasteurizing fermenting carbonating
cheese making 	cheese_making
chemical food preservation 	chemical_food_preservation
food irradiation 	food_irradiation
how winemaking works 	winemaking wine
how chocolate works 	chocolate
elixir of the gods: the history of chocolate - cocoa beans and the roasting process 	cocoa_beans
from jungle to chocolate factory - chocolate making 	chocolate_making
from cocoa bean to paste - chocolate: lots more information 	chocolate
tempering and conching chocolate - how chocolate works 	chocolate
why designer chocolate costs so much - how chocolate works 	chocolate
current trends in chocolate - how chocolate works 	chocolate
lots more information - how chocolate works 	chocolate
how sugar works 	sugar
types of sugar 	types_of_sugar
sugar in nature and the body 	sugar_in_nature
sugar production 	sugar_production
fueling you and your car: uses of sugar - uses of sugar 	uses_of_sugar
sugar: a natural explosive 	sugar
just breathe 	breathe breath
elemental haiku: a poetic take on the periodic table 	
how the periodic table works 	periodic_table the_periodic_table
getting organized: origins of the periodic table 	origins_of_the_periodic_table
building the periodic table block by block 	periodic_table_block
trends in the periodic table 	trends_in_the_periodic_table
iupac: the gatekeeper of elements 	iupac gatekeeper_of_elements elements
how aluminum works 	aluminum
aluminum 101 	aluminum
aluminum smelting 	aluminum_smelting
aluminum fabricating 	aluminum_fabricating
using and recycling aluminum 	recycling_aluminum
the future of aluminum 	future_of_aluminum
top things to recycle 	things_to_recycle
how ozone pollution works 	ozone pollution
infrasound and the body 	infrasound
here's where to find the cleanest air in the world 	
the magical medicine of bezoars 	
how magic mushrooms work 	magic_mushrooms shrooms
how lsd works 	lsd
lsd history 	lsd_history
how to make lsd 	how_to_make_lsd
lsd trips: something happened to me yesterday - lsd trips 	lsd_trips
lsd effects on the body: melts your mind, not in your hands - lsd effects 	lsd_effects
lsd dangers and abuse - lsd dangers 	lsd_dangers
lsd as medicine: opening the doors of perception - lsd as medicine 	lsd_as_medicine
cultural history of lsd: turn on, tune in, drop out - history of lsd 	history_of_lsd
lsd drug laws today - lsd drug 	lsd_drug lsd_drug_laws
how lucid dreaming works 	lucid_dreaming
background of lucid dreams 	background_of_lucid_dreams
how dreams work 	dreams
dreams: the theoretical divide - theories of dreams 	theories_of_dreams
dreaming and the brain - dreams: stages of sleep 	stages_of_sleep dreams
dreams and rem sleep 	rem_sleep
dream recall 	dream_recall
controlling dreams 	controlling_dreams
dream incubation 	dream_incubation
recurring dreams and nightmares 	recurring_dreams nightmares
premonitions in dreams 	premonitions_in_dreams
dreams: lots more information 	dreams
how sleep works 	sleep
sleep and the brain - the brain and sleep 	brain sleep
missing sleep - sleep deprivation 	sleep_deprivation sleep
dreams and improving sleep habits 	dreams sleep
how caffeine works 	caffeine
what is caffeine? 	what_is_caffeine
caffeine in the diet 	caffeine_in_the_diet
medicinal uses for caffeine - caffeine and adenosine 	caffeine_and_adenosine adenosine
caffeine and adenosine - caffeine and dopamine 	caffeine_and_dopamine dopamine
caffeine and dopamine - health benefits of caffeine 	health_benefits_of_caffeine
lots more information - how caffeine works 	caffeine
how coffee works 	coffee
how nicotine works 	nicotine
how electronic cigarettes work 	electronic_cigarette
